........................
........................
....................G...
........................
......B....P.........R..
......PPPP..............
.....PPPPPP............
....PPPPPPPP...........
PPPPPPPPPPPPPPPPPPPPPPP
